2 13 31
###############################
#p * *2      *   ** * *      *#
# # # # #*# # #*# # # # # #*# #
#    * * *** *4      *    **  #
# #*# # # # #1# #b#1# # # # #*#
#          *     **      *  **#
# # #*# # # # # #*#*#*#*# # # #
#   *        *   * *x* *      #
# # # # #*# # # # # # #*# #*# #
#   ****         *1           #
# # # # # # # # # #*# # # # #*#
#  ** *   *    2              #
###############################